SrcAddr,Sport,DstAddr,Dport,TotPkts,TotBytes,Dur,SrcPkts,DstPkts,SrcBytes,DstBytes,Rate,SrcRate,DstRate
192.168.1.2,37922,209.97.172.191,https,94,57732,3.86524,47,47,7404,50328,24.0606,11.900943,11.900943
192.168.1.2,37924,209.97.172.191,https,118,76901,3.7367660000000003,54,64,9765,67136,31.310495,14.183387,16.859497
192.168.1.2,37926,209.97.172.191,https,51,23854,3.735376,27,24,6091,17763,13.385532999999999,6.960477,6.1573459999999995
192.168.1.2,37928,209.97.172.191,https,105,66953,3.8184150000000003,48,57,9286,57667,27.236433,12.308772,14.665771
192.168.1.2,37930,209.97.172.191,https,115,73765,1.101879,53,62,7360,66405,103.459633,47.192116,55.359981999999995
192.168.1.2,37932,209.97.172.191,https,59,29363,3.790222,30,29,5621,23742,15.302534,7.651267,7.38743
192.168.1.2,37938,209.97.172.191,https,30,11989,4.9554540000000005,16,14,3532,8457,5.852138,3.026968,2.6233720000000003
192.168.1.2,37922,209.97.172.191,https,42,26979,2.948651,19,23,3871,23108,13.904663000000001,6.104486,7.4610389999999995
192.168.1.2,37924,209.97.172.191,https,88,55038,2.975981,44,44,6786,48252,29.234058,14.449017000000001,14.449017000000001
192.168.1.2,37928,209.97.172.191,https,64,40154,3.1166490000000002,32,32,5901,34253,20.21402,9.946581,9.946581
192.168.1.2,37926,209.97.172.191,https,54,41625,3.0437939999999997,20,34,4656,36969,17.412479,6.24221,10.841733
192.168.1.2,37932,209.97.172.191,https,60,37143,2.975756,30,30,3744,33399,19.826895,9.745422999999999,9.745422999999999
192.168.1.2,37938,209.97.172.191,https,31,18852,2.584841,15,16,2238,16614,11.60613,5.416194,5.803065
192.168.1.2,37940,209.97.172.191,https,414,298138,0.481835,190,224,11882,286256,857.1398929999999,392.250458,462.81402599999996
192.168.1.2,37942,209.97.172.191,https,79,64876,0.202406,27,52,2571,62305,385.364075,128.454681,251.968811
192.168.1.2,37944,209.97.172.191,https,53,38390,0.154942,21,32,2221,36169,335.60943599999996,129.080551,200.07486
192.168.1.2,37946,209.97.172.191,https,970,701706,0.701902,450,520,25881,675825,1380.534668,639.6904910000001,739.419495
192.168.1.2,37928,209.97.172.191,https,41,32037,0.227931,16,25,2414,29623,175.491714,65.809395,105.295029
192.168.1.2,37922,209.97.172.191,https,14,6757,0.11778499999999999,7,7,1809,4948,110.37058999999999,50.940273,50.940273
192.168.1.2,37924,209.97.172.191,https,8,4886,0.11492000000000001,4,4,926,3960,60.911942,26.105118,26.105118
192.168.1.2,37926,209.97.172.191,https,22,11906,0.094588,11,11,1909,9997,222.01548799999998,105.72165700000001,105.72165700000001
192.168.1.2,37932,209.97.172.191,https,20,12381,0.11290499999999999,10,10,1248,11133,168.283066,79.71302800000001,79.71302800000001
192.168.1.2,37938,209.97.172.191,https,14,8082,0.07705,7,7,1085,6997,168.72160300000002,77.87151300000001,77.87151300000001
192.168.1.2,37962,209.97.172.191,https,41,20862,0.12751500000000002,22,19,2290,18572,313.68856800000003,164.686508,141.159866
192.168.1.2,37964,209.97.172.191,https,17,6321,0.103452,9,8,1149,5172,154.661102,77.330551,67.66423
192.168.1.2,37966,209.97.172.191,https,17,6321,0.093044,9,8,1149,5172,171.961655,85.980827,75.233223
192.168.1.2,37968,209.97.172.191,https,17,6321,0.086564,9,8,1149,5172,184.834351,92.417175,80.86502800000001
192.168.1.2,37970,209.97.172.191,https,17,6321,0.081366,9,8,1149,5172,196.642319,98.321159,86.031021
192.168.1.2,37972,209.97.172.191,https,41,21005,0.15637,22,19,2433,18572,255.80354300000002,134.29686,115.111595
192.168.1.2,37970,209.97.172.191,https,5,313,0.020293000000000002,3,2,193,120,197.112305,98.556152,49.278076
192.168.1.2,37968,209.97.172.191,https,5,313,0.020952000000000002,3,2,193,120,190.912567,95.456284,47.728142
192.168.1.2,37964,209.97.172.191,https,5,313,0.019293,3,2,193,120,207.329071,103.664536,51.832268
192.168.1.2,37966,209.97.172.191,https,5,313,0.02018,3,2,193,120,198.216049,99.108025,49.554012
192.168.1.2,37980,209.97.172.191,https,11,1364,0.039938999999999995,6,5,918,446,250.381821,125.19091,100.152733
192.168.1.2,37982,209.97.172.191,https,7,416,0.039469,4,3,236,180,152.01803600000002,76.00901800000001,50.67268
192.168.1.2,37984,209.97.172.191,https,11,1364,0.039560000000000005,6,5,918,446,252.78057900000002,126.390289,101.112228
192.168.1.2,37986,209.97.172.191,https,7,416,0.0399,4,3,236,180,150.375931,75.187965,50.125313
192.168.1.2,37988,209.97.172.191,https,3,188,0.007427,2,1,128,60,269.28772000000004,134.64386000000002,0.0
192.168.1.2,37990,209.97.172.191,https,3,188,0.003796,2,1,128,60,526.870361,263.435181,0.0
192.168.1.2,37992,209.97.172.191,https,3,188,0.0041,2,1,128,60,487.804871,243.902435,0.0
192.168.1.2,37994,209.97.172.191,https,3,188,0.004014,2,1,128,60,498.256134,249.128067,0.0
192.168.1.2,37996,209.97.172.191,https,3,188,0.015369999999999998,2,1,128,60,130.123611,65.061806,0.0
192.168.1.2,37998,209.97.172.191,https,11,1364,0.037353,6,5,918,446,267.716095,133.858047,107.086441
192.168.1.2,38000,209.97.172.191,https,7,416,0.038179000000000005,4,3,236,180,157.154465,78.577232,52.384819
192.168.1.2,38002,209.97.172.191,https,11,1364,0.040785,6,5,918,446,245.188187,122.59409299999999,98.075272
192.168.1.2,38004,209.97.172.191,https,3,188,0.008145,2,1,128,60,245.549423,122.77471200000001,0.0
192.168.1.2,38006,209.97.172.191,https,3,188,0.005032,2,1,128,60,397.456268,198.728134,0.0
192.168.1.2,38008,209.97.172.191,https,11,1364,0.038439,6,5,918,446,260.152466,130.076233,104.060982
192.168.1.2,38010,209.97.172.191,https,11,1364,0.038672000000000005,6,5,918,446,258.58502200000004,129.29251100000002,103.43400600000001
192.168.1.2,38012,209.97.172.191,https,9,1250,0.037756,5,4,864,386,211.886856,105.943428,79.457573
192.168.1.2,37944,209.97.172.191,https,2,114,0.022205000000000003,1,1,54,60,45.034901,0.0,0.0
192.168.1.2,37942,209.97.172.191,https,2,114,0.018498,1,1,54,60,54.059898,0.0,0.0
192.168.1.2,37940,209.97.172.191,https,2,114,0.019400999999999998,1,1,54,60,51.543732,0.0,0.0
192.168.1.2,37946,209.97.172.191,https,2,114,0.018862999999999998,1,1,54,60,53.013836,0.0,0.0
192.168.1.2,37938,209.97.172.191,https,70,39768,4.881367,34,36,6691,33077,14.135384,6.760401,7.170122
192.168.1.2,37926,209.97.172.191,https,79,50627,4.831817,32,47,7928,42699,16.142996,6.415806,9.520227
192.168.1.2,37928,209.97.172.191,https,193,129718,4.938784,92,101,11168,118550,38.875965,18.425589000000002,20.247898
192.168.1.2,37932,209.97.172.191,https,96,57718,4.892608,48,48,6131,51587,19.417046,9.606328,9.606328
192.168.1.2,37924,209.97.172.191,https,82,54988,4.8556349999999995,36,46,7778,47210,16.681648000000003,7.20812,9.267583
192.168.1.2,37922,209.97.172.191,https,84,47891,4.8567,40,44,7637,40254,17.089794,8.030144,8.853748
192.168.1.2,37940,209.97.172.191,https,2,114,0.018524000000000002,1,1,54,60,53.984019999999994,0.0,0.0
192.168.1.2,37942,209.97.172.191,https,2,114,0.018373,1,1,54,60,54.42769200000001,0.0,0.0
192.168.1.2,37944,209.97.172.191,https,2,114,0.018149000000000002,1,1,54,60,55.099456999999994,0.0,0.0
192.168.1.2,37946,209.97.172.191,https,2,114,0.019233,1,1,54,60,51.993969,0.0,0.0
192.168.1.2,37924,209.97.172.191,https,66,42528,2.082709,33,33,4105,38423,31.209352000000003,15.364604,15.364604
192.168.1.2,37928,209.97.172.191,https,28,15925,2.080027,14,14,2960,12965,12.9806,6.249918,6.249918
192.168.1.2,37926,209.97.172.191,https,70,46085,2.471645,35,35,4322,41763,27.916629999999998,13.756020999999999,13.756020999999999
192.168.1.2,37922,209.97.172.191,https,39,23653,2.052404,17,22,3638,20015,18.514874,7.795736,10.231904
192.168.1.2,37932,209.97.172.191,https,48,30408,2.0814619999999997,24,24,2777,27631,22.580284,11.049926,11.049926
192.168.1.2,37938,209.97.172.191,https,40,24346,2.4128439999999998,20,20,3347,20999,16.163498,7.874525,7.874525
192.168.1.2,37940,209.97.172.191,https,2,114,0.01882,1,1,54,60,53.13496,0.0,0.0
192.168.1.2,37942,209.97.172.191,https,2,114,0.018837,1,1,54,60,53.087013,0.0,0.0
192.168.1.2,37944,209.97.172.191,https,2,114,0.018185,1,1,54,60,54.990376,0.0,0.0
192.168.1.2,37946,209.97.172.191,https,2,114,0.018673,1,1,54,60,53.553256999999995,0.0,0.0
192.168.1.2,37922,209.97.172.191,https,83,68760,4.519095,29,54,3801,64959,18.145226,6.195931,11.728012
192.168.1.2,37924,209.97.172.191,https,27,17089,4.383624,12,15,2131,14958,5.931166,2.5093389999999998,3.193705
192.168.1.2,37932,209.97.172.191,https,46,28956,3.8644830000000003,23,23,1976,26980,11.644506,5.69287,5.69287
192.168.1.2,37928,209.97.172.191,https,16,8487,3.785021,8,8,1168,7319,3.96299,1.8493950000000001,1.8493950000000001
192.168.1.2,37938,209.97.172.191,https,26,15992,3.4015120000000003,13,13,1435,14557,7.349672999999999,3.527843,3.527843
192.168.1.2,37926,209.97.172.191,https,16,9041,3.416832,8,8,1166,7875,4.390031,2.048681,2.048681
192.168.1.2,37940,209.97.172.191,https,2,114,0.018387999999999998,1,1,54,60,54.383297,0.0,0.0
192.168.1.2,37942,209.97.172.191,https,2,114,0.018908,1,1,54,60,52.887668999999995,0.0,0.0
192.168.1.2,37944,209.97.172.191,https,2,114,0.018212,1,1,54,60,54.908852,0.0,0.0
192.168.1.2,37922,209.97.172.191,https,114,73499,3.822125,57,57,6819,66680,29.564705,14.651535999999998,14.651535999999998
192.168.1.2,37926,209.97.172.191,https,51,30872,3.7880510000000003,24,27,4890,25982,13.1994,6.071724,6.863688000000001
192.168.1.2,37932,209.97.172.191,https,111,76361,3.882818,51,60,7227,69134,28.329940999999998,12.877245,15.195148999999999
192.168.1.2,37924,209.97.172.191,https,56,41769,3.877129,20,36,4470,37299,14.185754000000001,4.900533,9.027298
192.168.1.2,37928,209.97.172.191,https,72,46115,3.727147,36,36,4096,42019,19.049423,9.39056,9.39056
192.168.1.2,37938,209.97.172.191,https,52,32047,3.831953,26,26,3551,28496,13.30914,6.524088,6.524088
192.168.1.2,37946,209.97.172.191,https,2,114,0.018907,1,1,54,60,52.890465,0.0,0.0
192.168.1.2,37922,209.97.172.191,https,28,15579,2.628559,14,14,2960,12619,10.271788,4.945675,4.945675
192.168.1.2,37926,209.97.172.191,https,32,23272,2.6268290000000003,12,20,2850,20422,11.801302,4.187558999999999,7.2330559999999995
192.168.1.2,37928,209.97.172.191,https,20,12618,2.568252,10,10,2025,10593,7.398028,3.5043290000000002,3.5043290000000002
192.168.1.2,37932,209.97.172.191,https,53,37377,2.647643,22,31,4029,33348,19.64011,7.931582000000001,11.330832000000001
192.168.1.2,37924,209.97.172.191,https,81,53455,2.8712299999999997,40,41,4588,48867,27.862625,13.583029999999999,13.931313000000001
192.168.1.2,37938,209.97.172.191,https,38,22054,2.839773,19,19,3293,18761,13.029211,6.338535,6.338535
192.168.1.2,37940,209.97.172.191,https,2,114,0.018254,1,1,54,60,54.782513,0.0,0.0
192.168.1.2,37942,209.97.172.191,https,2,114,0.018966999999999998,1,1,54,60,52.723147999999995,0.0,0.0
192.168.1.2,37944,209.97.172.191,https,2,114,0.01811,1,1,54,60,55.218113,0.0,0.0
192.168.1.2,37946,209.97.172.191,https,2,114,0.018930000000000002,1,1,54,60,52.826202,0.0,0.0
192.168.1.2,37922,209.97.172.191,https,52,30482,4.645033,26,26,4325,26157,10.97947,5.382093,5.382093
192.168.1.2,37926,209.97.172.191,https,37,21048,4.690405,20,17,4726,16322,7.675242999999999,4.050823,3.4112190000000004
192.168.1.2,37928,209.97.172.191,https,69,49464,4.903812,30,39,5467,43997,13.866763,5.913767,7.749074
192.168.1.2,37932,209.97.172.191,https,75,49308,4.686428,33,42,5960,43348,15.790277,6.828228,8.748667999999999
192.168.1.2,37924,209.97.172.191,https,102,65914,4.928983000000001,51,51,5912,60002,20.491041,10.14408,10.14408
192.168.1.2,37938,209.97.172.191,https,42,24606,4.665508999999999,21,21,3331,21275,8.787894,4.286777,4.286777
192.168.1.2,37940,209.97.172.191,https,8,512,3.9873410000000002,4,4,247,265,1.7555560000000001,0.7523810000000001,0.7523810000000001
192.168.1.2,37942,209.97.172.191,https,8,512,3.884376,4,4,247,265,1.8020909999999999,0.772325,0.772325
192.168.1.2,37944,209.97.172.191,https,8,512,3.832096,4,4,247,265,1.8266759999999997,0.7828609999999999,0.7828609999999999
192.168.1.2,37946,209.97.172.191,https,8,512,3.880514,4,4,247,265,1.803885,0.773093,0.773093
192.168.1.2,37938,209.97.172.191,https,2,114,0.026273,1,1,54,60,38.061890000000005,0.0,0.0
192.168.1.2,37922,209.97.172.191,https,2,114,0.025901999999999998,1,1,54,60,38.607059,0.0,0.0
192.168.1.2,37932,209.97.172.191,https,2,114,0.026126999999999997,1,1,54,60,38.274582,0.0,0.0
192.168.1.2,37926,209.97.172.191,https,2,114,0.026075,1,1,54,60,38.35091,0.0,0.0
192.168.1.2,37924,209.97.172.191,https,2,114,0.021195,1,1,54,60,47.180939,0.0,0.0
192.168.1.2,37928,209.97.172.191,https,2,114,0.025245,1,1,54,60,39.611805,0.0,0.0
192.168.1.2,37922,209.97.172.191,https,2,114,0.018917,1,1,54,60,52.862503000000004,0.0,0.0
192.168.1.2,37938,209.97.172.191,https,2,114,0.018787,1,1,54,60,53.22829399999999,0.0,0.0
192.168.1.2,37932,209.97.172.191,https,2,114,0.019535,1,1,54,60,51.190174,0.0,0.0
192.168.1.2,37926,209.97.172.191,https,2,114,0.020807,1,1,54,60,48.060749,0.0,0.0
192.168.1.2,37924,209.97.172.191,https,2,114,0.157539,1,1,54,60,6.3476349999999995,0.0,0.0
192.168.1.2,37928,209.97.172.191,https,2,114,0.157201,1,1,54,60,6.361282,0.0,0.0
192.168.1.2,37922,209.97.172.191,https,2,114,0.020474000000000003,1,1,54,60,48.842434000000004,0.0,0.0
192.168.1.2,37938,209.97.172.191,https,2,114,0.020398,1,1,54,60,49.024414,0.0,0.0
192.168.1.2,37932,209.97.172.191,https,2,114,0.020353,1,1,54,60,49.132805,0.0,0.0
192.168.1.2,37926,209.97.172.191,https,2,114,0.020211,1,1,54,60,49.478008,0.0,0.0
192.168.1.2,37924,209.97.172.191,https,2,114,0.018641,1,1,54,60,53.645187,0.0,0.0
192.168.1.2,37928,209.97.172.191,https,2,114,0.022963,1,1,54,60,43.548317,0.0,0.0
192.168.1.2,37938,209.97.172.191,https,2,114,0.021255,1,1,54,60,47.047756,0.0,0.0
192.168.1.2,37922,209.97.172.191,https,2,114,0.020981,1,1,54,60,47.66217,0.0,0.0
192.168.1.2,37932,209.97.172.191,https,2,114,0.020881999999999998,1,1,54,60,47.888134,0.0,0.0
192.168.1.2,37926,209.97.172.191,https,2,114,0.020719,1,1,54,60,48.264881,0.0,0.0
192.168.1.2,37924,209.97.172.191,https,2,114,0.019476,1,1,54,60,51.345245,0.0,0.0
192.168.1.2,37928,209.97.172.191,https,2,114,0.020246,1,1,54,60,49.392475,0.0,0.0
192.168.1.2,37938,209.97.172.191,https,2,114,0.019196,1,1,54,60,52.094184999999996,0.0,0.0
192.168.1.2,37922,209.97.172.191,https,2,114,0.019043,1,1,54,60,52.512733,0.0,0.0
192.168.1.2,37932,209.97.172.191,https,2,114,0.01898,1,1,54,60,52.687038,0.0,0.0
192.168.1.2,37926,209.97.172.191,https,2,114,0.018852,1,1,54,60,53.044773,0.0,0.0
192.168.1.2,37924,209.97.172.191,https,2,114,0.018415,1,1,54,60,54.303555,0.0,0.0
192.168.1.2,37928,209.97.172.191,https,2,114,0.019191,1,1,54,60,52.107758000000004,0.0,0.0
192.168.1.2,37922,209.97.172.191,https,8,512,3.632592,4,4,247,265,1.9269990000000001,0.825857,0.825857
192.168.1.2,37938,209.97.172.191,https,8,512,3.632947,4,4,247,265,1.92681,0.8257760000000001,0.8257760000000001
192.168.1.2,37932,209.97.172.191,https,8,512,3.632855,4,4,247,265,1.926859,0.8257969999999999,0.8257969999999999
192.168.1.2,37926,209.97.172.191,https,8,512,3.632187,4,4,247,265,1.927214,0.8259489999999999,0.8259489999999999
192.168.1.2,37924,209.97.172.191,https,8,512,3.589836,4,4,247,265,1.94995,0.835693,0.835693
192.168.1.2,37928,209.97.172.191,https,8,512,3.584443,4,4,247,265,1.952884,0.83695,0.83695
192.168.1.2,38036,209.97.172.191,https,154,107410,4.3949419999999995,66,88,10310,97100,34.812748,14.789729000000001,19.795485
192.168.1.2,38038,209.97.172.191,https,110,66706,4.964930000000001,52,58,8490,58216,21.953985,10.272048,11.480524
192.168.1.2,38040,209.97.172.191,https,123,74644,4.40908,60,63,8998,65646,27.670171999999997,13.381476000000001,14.061891000000001
192.168.1.2,38042,209.97.172.191,https,231,157578,4.980476,106,125,13102,144476,46.180325,21.082323000000002,24.897219
192.168.1.2,38044,209.97.172.191,https,106,79798,4.411497,38,68,7906,71892,23.801443,8.387176,15.187588
192.168.1.2,38046,209.97.172.191,https,90,59734,4.453208999999999,38,52,7755,51979,19.985588,8.308616,11.452415
192.168.1.2,38042,209.97.172.191,https,14,8930,0.668466,7,7,1112,7818,19.447512,8.975775,8.975775
192.168.1.2,38040,209.97.172.191,https,91,60858,4.997240000000001,46,45,4820,56038,18.009941,9.004971000000001,8.804860000000001
192.168.1.2,38038,209.97.172.191,https,19,17379,4.9975510000000005,5,14,2491,14888,3.6017639999999997,0.800392,2.601274
192.168.1.2,38044,209.97.172.191,https,24,18761,4.997864,9,15,2587,16174,4.601966,1.600684,2.801197
192.168.1.2,38036,209.97.172.191,https,44,29471,4.992903,22,22,2542,26929,8.612224000000001,4.20597,4.20597
192.168.1.2,38046,209.97.172.191,https,25,16675,4.995191999999999,13,12,2168,14507,4.80462,2.40231,2.202117
192.168.1.2,38042,209.97.172.191,https,15,9181,4.9980709999999995,8,7,1900,7281,2.80108,1.40054,1.2004629999999998
192.168.1.2,38040,209.97.172.191,https,91,60666,4.3825330000000005,45,46,4032,56634,20.536068,10.039856,10.268034
192.168.1.2,38038,209.97.172.191,https,12,8273,4.99985,4,8,952,7321,2.200066,0.600018,1.400042
192.168.1.2,38044,209.97.172.191,https,34,28311,4.981999,12,22,1382,26929,6.6238470000000005,2.207949,4.2151760000000005
192.168.1.2,38036,209.97.172.191,https,31,18411,4.964345,15,16,2177,16234,6.043093,2.8201099999999997,3.021547
192.168.1.2,38046,209.97.172.191,https,39,24699,4.998454,19,20,2508,22191,7.602351,3.601113,3.801175
192.168.1.2,38042,209.97.172.191,https,25,16982,4.3428379999999995,11,14,2077,14905,5.52634,2.3026419999999996,2.993434
192.168.1.2,38044,209.97.172.191,https,44,28737,4.359494000000001,22,22,1808,26929,9.863529,4.8170720000000005,4.8170720000000005
192.168.1.2,38036,209.97.172.191,https,24,18141,4.9930639999999995,9,15,1967,16174,4.60639,1.602223,2.80389
192.168.1.2,38040,209.97.172.191,https,72,59628,4.439757,27,45,3060,56568,15.991867000000001,5.8561760000000005,9.910453
192.168.1.2,38046,209.97.172.191,https,30,19825,4.381498000000001,15,15,1543,18282,6.618741,3.1952540000000003,3.1952540000000003
192.168.1.2,38038,209.97.172.191,https,22,16441,4.989549,8,14,1917,14524,4.208797,1.402932,2.6054459999999997
192.168.1.2,38042,209.97.172.191,https,11,8231,4.983964,4,7,950,7281,2.0064349999999997,0.60193,1.203861
192.168.1.2,38044,209.97.172.191,https,30,18465,4.972981,15,15,2291,16174,5.831512,2.815213,2.815213
192.168.1.2,38040,209.97.172.191,https,104,69667,4.998928,52,52,5278,64389,20.604418,10.202188,10.202188
192.168.1.2,38036,209.97.172.191,https,58,43309,4.989708,24,34,2663,40646,11.423513999999999,4.609488,6.613614
192.168.1.2,38046,209.97.172.191,https,24,15889,4.380249,12,12,1381,14508,5.250843,2.511273,2.511273
192.168.1.2,38038,209.97.172.191,https,20,15941,4.533911,7,13,1114,14827,4.1906419999999995,1.323361,2.646721
192.168.1.2,38042,209.97.172.191,https,11,8231,4.9823889999999995,4,7,950,7281,2.007069,0.602121,1.204242
192.168.1.2,38044,209.97.172.191,https,43,28683,4.37469,21,22,1754,26929,9.60068,4.571753,4.80034
192.168.1.2,38036,209.97.172.191,https,20,12105,4.3870510000000005,10,10,2023,10082,4.330927,2.0514919999999996,2.0514919999999996
192.168.1.2,38046,209.97.172.191,https,24,15888,4.388751,12,12,1381,14507,5.240671,2.506408,2.506408
192.168.1.2,38040,209.97.172.191,https,90,60606,4.463035,45,45,4032,56574,19.941585999999997,9.858761999999999,9.858761999999999
192.168.1.2,38038,209.97.172.191,https,23,17594,4.9973279999999995,9,14,2707,14887,4.402353,1.600856,2.6013900000000003
192.168.1.2,38042,209.97.172.191,https,11,8231,4.9804889999999995,4,7,950,7281,2.007835,0.602351,1.204701
192.168.1.2,38044,209.97.172.191,https,30,18351,4.9693510000000005,15,15,2177,16174,5.8357730000000005,2.817269,2.817269
192.168.1.2,38046,209.97.172.191,https,24,15887,4.4094940000000005,12,12,1381,14506,5.216018,2.494617,2.494617
192.168.1.2,38036,209.97.172.191,https,44,28851,4.371323,22,22,1922,26929,9.836839,4.804037999999999,4.804037999999999
192.168.1.2,38040,209.97.172.191,https,132,101273,4.993561,57,75,4680,96593,26.233786,11.214442,14.819084
192.168.1.2,38042,209.97.172.191,https,12,8291,4.985213,4,8,950,7341,2.2065259999999998,0.60178,1.404153
192.168.1.2,38044,209.97.172.191,https,27,19205,4.982355,10,17,2654,16551,5.218416,1.806375,3.211333
192.168.1.2,38038,209.97.172.191,https,12,8274,4.971495,4,8,952,7322,2.212614,0.60344,1.4080270000000001
192.168.1.2,38046,209.97.172.191,https,60,39679,4.948236,30,30,3102,36577,11.923441,5.8606739999999995,5.8606739999999995
192.168.1.2,38036,209.97.172.191,https,84,56743,4.907417,41,43,2948,53795,16.913176,8.150928,8.558475
192.168.1.2,38040,209.97.172.191,https,50,32844,4.995784,25,25,2952,29892,9.80827,4.804051,4.804051
192.168.1.2,38044,209.97.172.191,https,32,25559,4.931736,11,21,2077,23482,6.285819,2.027683,4.0553669999999995
192.168.1.2,38042,209.97.172.191,https,11,8232,4.315915,4,7,950,7282,2.317006,0.695102,1.390203
192.168.1.2,38038,209.97.172.191,https,22,16441,4.95907,8,14,1917,14524,4.234665000000001,1.411555,2.621459
192.168.1.2,38040,209.97.172.191,https,122,96232,4.917731,50,72,4302,91930,24.604845,9.963944999999999,14.437553
192.168.1.2,38036,209.97.172.191,https,25,18816,4.997013,10,15,2641,16175,4.802869,1.801076,2.801674
192.168.1.2,38046,209.97.172.191,https,26,16735,4.996954,13,13,2168,14567,5.003048000000001,2.401463,2.401463
192.168.1.2,38044,209.97.172.191,https,36,29320,4.430737000000001,12,24,2015,27305,7.899363,2.482657,5.1910099999999995
192.168.1.2,38042,209.97.172.191,https,11,8231,4.308081,4,7,950,7281,2.3212189999999997,0.696366,1.392731
192.168.1.2,38038,209.97.172.191,https,22,16922,4.621462999999999,8,14,2036,14886,4.544016,1.514672,2.8129619999999997
192.168.1.2,38040,209.97.172.191,https,15,9717,4.99958,8,7,1900,7817,2.800235,1.400118,1.200101
192.168.1.2,38036,209.97.172.191,https,34,28310,4.977197,12,22,1382,26928,6.630238,2.210079,4.2192419999999995
192.168.1.2,38046,209.97.172.191,https,60,39679,4.989795,30,30,3102,36577,11.824133,5.8118620000000005,5.8118620000000005
192.168.1.2,38044,209.97.172.191,https,41,34033,4.961253,14,27,2123,31910,8.062479,2.6203060000000002,5.2406120000000005
192.168.1.2,38042,209.97.172.191,https,20,15613,4.915001999999999,7,13,1112,14501,3.8657160000000004,1.220752,2.441505
192.168.1.2,38038,209.97.172.191,https,70,58099,4.388426,26,44,2140,55959,15.723178,5.696804,9.798502000000001
192.168.1.2,38040,209.97.172.191,https,77,59894,4.421804,32,45,3330,56564,17.187555,7.010714,9.95069
192.168.1.2,38036,209.97.172.191,https,57,37546,4.356199,28,29,2995,34551,12.855245,6.198064,6.427622
192.168.1.2,38038,209.97.172.191,https,29,17934,4.99989,15,14,3029,14905,5.600123,2.800062,2.600057
192.168.1.2,38042,209.97.172.191,https,12,9002,4.997757,5,7,1740,7262,2.200987,0.800359,1.200539
192.168.1.2,38044,209.97.172.191,https,24,18646,4.9997300000000005,9,15,2473,16173,4.600248000000001,1.6000860000000001,2.800151
192.168.1.2,38046,209.97.172.191,https,25,16675,4.999021,13,12,2168,14507,4.80094,2.40047,2.200431
192.168.1.2,38040,209.97.172.191,https,77,59907,4.998707,31,46,3276,56631,15.203933,6.001551999999999,9.002328
192.168.1.2,38036,209.97.172.191,https,45,28911,4.377343,22,23,1922,26989,10.05176,4.797431,5.02588
192.168.1.2,38042,209.97.172.191,https,12,8291,4.998387999999999,4,8,950,7341,2.20071,0.600194,1.400452
192.168.1.2,38038,209.97.172.191,https,15,8437,4.9996480000000005,7,8,1114,7323,2.8001970000000003,1.200084,1.400099
192.168.1.2,38044,209.97.172.191,https,23,18086,4.971928,8,15,1913,16173,4.424843,1.407905,2.8158090000000002
192.168.1.2,38046,209.97.172.191,https,36,24536,4.999364,16,20,2346,22190,7.000891,3.000382,3.8004830000000003
192.168.1.2,38040,209.97.172.191,https,72,67941,4.876729,20,52,3550,64391,14.558939,3.896054,10.457828999999998
192.168.1.2,38036,209.97.172.191,https,72,46354,4.975844,36,36,3311,43043,14.268935999999998,7.033983,7.033983
192.168.1.2,38044,209.97.172.191,https,34,28195,4.360099,12,22,1268,26927,7.568636,2.522879,4.816404
192.168.1.2,38042,209.97.172.191,https,22,16822,4.3682300000000005,8,14,1917,14905,4.807439,1.60248,2.976034
192.168.1.2,38046,209.97.172.191,https,19,15617,4.37196,7,12,1111,14506,4.117146,1.372382,2.516034
192.168.1.2,38038,209.97.172.191,https,14,8374,4.3506089999999995,7,7,1112,7262,2.9880869999999997,1.379117,1.379117
192.168.1.2,38040,209.97.172.191,https,58,58876,4.562716,13,45,2304,56572,12.492559,2.630013,9.643379
192.168.1.2,38036,209.97.172.191,https,55,37440,1.197481,26,29,2887,34553,45.094662,20.877157,23.382416
192.168.1.2,38044,209.97.172.191,https,30,18351,4.972683999999999,15,15,2177,16174,5.831861,2.815381,2.815381
192.168.1.2,38046,209.97.172.191,https,46,30926,4.964723,23,23,1975,28951,9.06395,4.431264,4.431264
192.168.1.2,38042,209.97.172.191,https,20,15594,4.948987000000001,7,13,1112,14482,3.8391699999999997,1.212369,2.4247389999999998
192.168.1.2,38038,209.97.172.191,https,28,16785,4.963037,14,14,2241,14544,5.440217,2.619364,2.619364
192.168.1.2,38040,209.97.172.191,https,57,58825,4.483015,12,45,2250,56575,12.491593,2.453706,9.814822999999999
192.168.1.2,38036,209.97.172.191,https,35,29096,4.9977339999999995,13,22,2170,26926,6.803083,2.401088,4.201904
192.168.1.2,38044,209.97.172.191,https,31,18411,4.984933,15,16,2177,16234,6.018135,2.808463,3.009068
192.168.1.2,38040,209.97.172.191,https,105,108107,4.927115000000001,23,82,2844,105263,21.107687,4.4650870000000005,16.43964
192.168.1.2,38038,209.97.172.191,https,37,24853,4.845974,17,20,2403,22450,7.428847,3.30171,3.92078
192.168.1.2,38042,209.97.172.191,https,11,8231,0.6911649999999999,4,7,950,7281,14.468326000000001,4.340498,8.680996
192.168.1.2,38046,209.97.172.191,https,24,15887,0.671902,12,12,1381,14506,34.231182000000004,16.371435,16.371435
192.168.1.2,38036,209.97.172.191,https,44,28736,4.375392,22,22,1808,26928,9.827691,4.79957,4.79957
192.168.1.2,38044,209.97.172.191,https,23,18081,4.993806,9,14,1967,16114,4.405457,1.601985,2.603225
192.168.1.2,38040,209.97.172.191,https,78,60691,4.99214,33,45,4118,56573,15.424248,6.410076999999999,8.813856
192.168.1.2,38042,209.97.172.191,https,12,9019,4.989142,5,7,1738,7281,2.204788,0.801741,1.202612
192.168.1.2,38038,209.97.172.191,https,23,17593,4.98728,9,14,2707,14886,4.411222,1.6040809999999999,2.606631
192.168.1.2,38046,209.97.172.191,https,26,16735,4.998963,13,13,2168,14567,5.001037,2.400498,2.400498
192.168.1.2,38036,209.97.172.191,https,31,18525,4.984213,15,16,2291,16234,6.019004,2.808869,3.009502
192.168.1.2,38044,209.97.172.191,https,38,29426,4.9913870000000005,14,24,2123,27303,7.412769,2.604486,4.607938
192.168.1.2,38040,209.97.172.191,https,76,59841,4.347989,31,45,3276,56565,17.249353,6.899741000000001,10.11962
192.168.1.2,38042,209.97.172.191,https,11,8231,4.9788120000000005,4,7,950,7281,2.008511,0.602553,1.205107
192.168.1.2,38038,209.97.172.191,https,22,16804,4.981568,8,14,1917,14887,4.21554,1.4051799999999999,2.60962
192.168.1.2,38044,209.97.172.191,https,27,17293,4.930086,13,14,1436,15857,5.2737419999999995,2.4340349999999997,2.6368709999999997
192.168.1.2,38046,209.97.172.191,https,24,15888,4.37823,12,12,1381,14507,5.253264,2.5124310000000003,2.5124310000000003
192.168.1.2,38036,209.97.172.191,https,44,29753,4.4361180000000004,20,24,2447,27306,9.693159,4.283024,5.1847129999999995
192.168.1.2,38040,209.97.172.191,https,60,58984,4.9889220000000005,15,45,2412,56572,11.826201,2.8062169999999997,8.81954
192.168.1.2,38042,209.97.172.191,https,11,8232,4.987166,4,7,950,7282,2.005147,0.601544,1.203088
192.168.1.2,38038,209.97.172.191,https,11,8212,4.990549,4,7,952,7260,2.003788,0.601136,1.202273
192.168.1.2,38044,209.97.172.191,https,58,37602,4.412780000000001,29,29,3049,34553,12.917027000000001,6.345207,6.345207
192.168.1.2,38046,209.97.172.191,https,24,15888,4.406919,12,12,1381,14507,5.219066000000001,2.496075,2.496075
192.168.1.2,38036,209.97.172.191,https,30,18352,4.441296,15,15,2177,16175,6.529625,3.1522330000000003,3.1522330000000003
192.168.1.2,38040,209.97.172.191,https,77,59910,4.453864,31,46,3276,56634,17.063835,6.735724,10.103586
192.168.1.2,38042,209.97.172.191,https,12,8291,4.986655000000001,4,8,950,7341,2.2058869999999997,0.6016060000000001,1.403746
192.168.1.2,38038,209.97.172.191,https,12,8275,4.984984,4,8,952,7323,2.206627,0.601807,1.404217
192.168.1.2,38046,209.97.172.191,https,38,24639,4.3522,19,19,2508,22131,8.501448,4.135839,4.135839
192.168.1.2,38044,209.97.172.191,https,65,45976,4.9784370000000004,29,36,2933,43043,12.85544,5.624255000000001,7.030319
192.168.1.2,38036,209.97.172.191,https,44,43939,4.939139,10,34,1274,42665,8.705971,1.82218,6.681325999999999
192.168.1.2,38046,209.97.172.191,https,24,15889,4.345561,12,12,1381,14508,5.292758,2.531319,2.531319
192.168.1.2,38040,209.97.172.191,https,75,59797,4.328984999999999,30,45,3222,56575,17.094076,6.6990289999999995,10.164045
192.168.1.2,38038,209.97.172.191,https,22,16804,4.329013,8,14,1917,14887,4.85099,1.616997,3.0029939999999997
192.168.1.2,38042,209.97.172.191,https,11,8230,4.318939,4,7,950,7280,2.315383,0.694615,1.38923
192.168.1.2,38036,209.97.172.191,https,21,17866,0.8078810000000001,6,15,1691,16175,24.756121,6.189030000000001,17.329285000000002
192.168.1.2,38044,209.97.172.191,https,82,79091,4.997898999999999,22,60,3410,75681,16.20681,4.201766,11.804960000000001
192.168.1.2,38038,209.97.172.191,https,33,25030,4.887326,12,21,2882,22148,6.547548,2.2507200000000003,4.092217
192.168.1.2,38042,209.97.172.191,https,20,15614,4.917247,7,13,1112,14502,3.863951,1.2201950000000001,2.4403900000000003
192.168.1.2,38046,209.97.172.191,https,48,31909,4.818073,24,24,2897,29012,9.754938000000001,4.773693,4.773693
192.168.1.2,38040,209.97.172.191,https,26,17010,4.83985,13,13,1436,15574,5.16545,2.479416,2.479416
192.168.1.2,38036,209.97.172.191,https,29,28041,0.711991,7,22,1112,26929,39.32634,8.427073,29.494754999999998
192.168.1.2,38044,209.97.172.191,https,30,18466,4.97368,15,15,2291,16175,5.830693,2.8148169999999997,2.8148169999999997
192.168.1.2,38046,209.97.172.191,https,109,77310,4.919503,50,59,4816,72494,21.953436,9.960355999999999,11.789808
192.168.1.2,38038,209.97.172.191,https,23,16102,4.474525,10,13,1276,14826,4.916723,2.011387,2.681849
192.168.1.2,38040,209.97.172.191,https,66,60044,4.999371,21,45,3470,56574,13.001636,4.000503,8.801107
192.168.1.2,38042,209.97.172.191,https,11,8231,0.716195,4,7,950,7281,13.962678,4.188803,8.377606
192.168.1.2,38036,209.97.172.191,https,25,16675,4.9946470000000005,13,12,2168,14507,4.805144,2.402572,2.2023580000000003
192.168.1.2,38044,209.97.172.191,https,41,28694,4.9904779999999995,18,23,1706,26988,8.015265,3.4064870000000003,4.408395
192.168.1.2,38038,209.97.172.191,https,11,8231,0.796714,4,7,950,7281,12.551556,3.7654669999999997,7.530933
192.168.1.2,38042,209.97.172.191,https,69,58918,1.3275620000000001,24,45,2900,56018,51.221714,17.324991,33.143463
192.168.1.2,38046,209.97.172.191,https,24,18761,4.998916,9,15,2587,16174,4.6009970000000004,1.600347,2.800607
192.168.1.2,38040,209.97.172.191,https,28,17681,4.981701999999999,14,14,2239,15442,5.419835,2.60955,2.60955
192.168.1.2,38036,209.97.172.191,https,24,15888,4.985412999999999,12,12,1381,14507,4.613459,2.2064369999999998,2.2064369999999998
192.168.1.2,38044,209.97.172.191,https,80,56530,4.9237779999999995,37,43,2732,53798,16.04459,7.311458999999999,8.530035
192.168.1.2,38038,209.97.172.191,https,22,16804,1.191124,8,14,1917,14887,17.630407,5.876802,10.914062
192.168.1.2,38042,209.97.172.191,https,31,19139,4.995119,16,15,2965,16174,6.005863,3.0029310000000002,2.802736
192.168.1.2,38040,209.97.172.191,https,76,59850,4.4356230000000005,31,45,3276,56574,16.90856,6.7634240000000005,9.919688
192.168.1.2,38046,209.97.172.191,https,11,8232,4.981787000000001,4,7,952,7280,2.0073119999999998,0.602194,1.204387
192.168.1.2,38036,209.97.172.191,https,24,15887,4.380888,12,12,1381,14506,5.250077,2.5109060000000003,2.5109060000000003
192.168.1.2,38038,209.97.172.191,https,24,18761,4.999325,9,15,2587,16174,4.600621,1.600216,2.800378
192.168.1.2,38044,209.97.172.191,https,40,28634,0.7491899999999999,18,22,1706,26928,52.056221,22.691174,28.030272999999998
192.168.1.2,38040,209.97.172.191,https,67,59367,4.441678,21,46,2736,56631,14.859248999999998,4.502803,10.131306
192.168.1.2,38042,209.97.172.191,https,15,8455,4.99876,7,8,1114,7341,2.800694,1.2002979999999999,1.400347
192.168.1.2,38046,209.97.172.191,https,22,16688,4.985682,8,14,1801,14887,4.212062,1.404021,2.6074669999999998
192.168.1.2,38036,209.97.172.191,https,24,15888,4.982348,12,12,1381,14507,4.616297,2.207794,2.207794
192.168.1.2,38044,209.97.172.191,https,43,29531,4.999434,21,22,2602,26929,8.400951,4.000453,4.200476
192.168.1.2,38038,209.97.172.191,https,11,8233,4.9820459999999995,4,7,952,7281,2.007207,0.602162,1.204324
192.168.1.2,38046,209.97.172.191,https,26,19151,4.991293,9,17,2600,16551,5.008722,1.602791,3.205582
192.168.1.2,38036,209.97.172.191,https,38,24639,4.980452,19,19,2508,22131,7.4290449999999995,3.6141300000000003,3.6141300000000003
192.168.1.2,38040,209.97.172.191,https,58,58877,4.4124870000000005,13,45,2304,56573,12.917885,2.7195549999999997,9.971701
192.168.1.2,38042,209.97.172.191,https,26,15914,4.94236,13,13,1436,14478,5.058312,2.4279900000000003,2.4279900000000003
192.168.1.2,38038,209.97.172.191,https,11,8212,4.987481,4,7,952,7260,2.00502,0.601506,1.203012
192.168.1.2,38044,209.97.172.191,https,41,28689,4.983087,19,22,1760,26929,8.027153,3.612219,4.2142550000000005
192.168.1.2,38036,209.97.172.191,https,24,15887,4.983244,12,12,1381,14506,4.615468,2.2073970000000003,2.2073970000000003
192.168.1.2,38046,209.97.172.191,https,34,26563,4.955508999999999,12,22,2764,23799,6.659255,2.219752,4.2377080000000005
192.168.1.2,38040,209.97.172.191,https,90,68912,4.957978,38,52,4522,64390,17.950867000000002,7.46272,10.286452
192.168.1.2,38042,209.97.172.191,https,15,9180,4.9935540000000005,8,7,1900,7280,2.803614,1.401807,1.201549
192.168.1.2,38038,209.97.172.191,https,12,8275,4.994144,4,8,952,7323,2.2025799999999998,0.600704,1.401642
192.168.1.2,38044,209.97.172.191,https,43,28802,4.985405999999999,20,23,1814,26988,8.42459,3.811124,4.41288
192.168.1.2,38036,209.97.172.191,https,25,15948,4.986837,12,13,1381,14567,4.81267,2.205807,2.406335
192.168.1.2,38046,209.97.172.191,https,35,26622,4.479544000000001,12,23,2764,23858,7.590058,2.455607,4.911214
192.168.1.2,38040,209.97.172.191,https,76,59841,4.56405,31,45,3276,56565,16.432774,6.573109,9.64056
192.168.1.2,38042,209.97.172.191,https,14,8393,4.983414,7,7,1112,7281,2.608653,1.203994,1.203994
192.168.1.2,38038,209.97.172.191,https,45,34789,4.957186,16,29,3729,31060,8.876003,3.0259099999999997,5.648365
192.168.1.2,38036,209.97.172.191,https,46,30929,4.957034999999999,23,23,1975,28954,9.078007000000001,4.438137,4.438137
192.168.1.2,38044,209.97.172.191,https,80,56530,4.915847,37,43,2732,53798,16.070477,7.3232550000000005,8.543797
192.168.1.2,38046,209.97.172.191,https,29,24275,4.919382,10,19,1276,22999,5.691772,1.8294979999999998,3.6589959999999997
192.168.1.2,38040,209.97.172.191,https,124,109137,4.913779,42,82,3870,105267,25.031651999999998,8.343884,16.484258999999998
192.168.1.2,38042,209.97.172.191,https,15,8453,4.993305,7,8,1112,7341,2.803754,1.201609,1.401877
192.168.1.2,38038,209.97.172.191,https,34,26562,4.820704,12,22,2764,23798,6.845472999999999,2.2818240000000003,4.35621
192.168.1.2,38040,209.97.172.191,https,14,8930,0.8993559999999999,7,7,1112,7818,14.454787,6.671441000000001,6.671441000000001
192.168.1.2,38046,209.97.172.191,https,12,9002,4.997713,5,7,1740,7262,2.201007,0.800366,1.200549
192.168.1.2,38044,209.97.172.191,https,43,29531,4.996956,21,22,2602,26929,8.405117,4.0024370000000005,4.202559
192.168.1.2,38036,209.97.172.191,https,25,16674,4.995271,13,12,2168,14506,4.804544,2.402272,2.202083
192.168.1.2,38042,209.97.172.191,https,112,77248,4.826569,53,59,5097,72151,22.997702,10.773699,12.016817
192.168.1.2,38038,209.97.172.191,https,31,24529,4.774083,11,20,2079,22450,6.283929,2.094643,3.979822
192.168.1.2,38040,209.97.172.191,https,79,60010,1.385383,34,45,3438,56572,56.302119999999995,23.820127,31.760170000000002
192.168.1.2,38046,209.97.172.191,https,9,8122,4.982183999999999,2,7,842,7280,1.605721,0.200715,1.204291
192.168.1.2,38044,209.97.172.191,https,41,28689,4.983631,19,22,1760,26929,8.026277,3.611824,4.213794999999999
192.168.1.2,38036,209.97.172.191,https,24,15888,4.984447,12,12,1381,14507,4.6143529999999995,2.206865,2.206865
192.168.1.2,38040,209.97.172.191,https,66,59310,1.182788,21,45,2736,56574,54.954903,16.909201,37.200241
192.168.1.2,38042,209.97.172.191,https,11,8215,0.684556,4,7,952,7263,14.608007999999998,4.382402,8.764805
192.168.1.2,38038,209.97.172.191,https,23,17974,0.6751,8,15,1799,16175,32.587765000000005,10.368834,20.737667000000002
192.168.1.2,38046,209.97.172.191,https,9,8124,4.983587,2,7,842,7282,1.60527,0.200659,1.2039520000000001
192.168.1.2,38044,209.97.172.191,https,56,37492,4.985403,27,29,2941,34551,11.032207000000001,5.215225,5.616396
192.168.1.2,38036,209.97.172.191,https,24,15887,4.9839269999999996,12,12,1381,14506,4.614835,2.2070950000000003,2.2070950000000003
192.168.1.2,38040,209.97.172.191,https,59,58932,1.3895680000000001,14,45,2358,56574,41.739594,9.355426,31.664518
192.168.1.2,38038,209.97.172.191,https,12,9004,4.9972900000000005,5,7,1742,7262,2.201193,0.800434,1.200651
192.168.1.2,38042,209.97.172.191,https,35,27236,4.999682,13,22,3438,23798,6.800433,2.400153,4.200267
192.168.1.2,38046,209.97.172.191,https,9,8123,4.986204,2,7,842,7281,1.604427,0.200553,1.2033200000000002
192.168.1.2,38044,209.97.172.191,https,41,28688,4.982183999999999,19,22,1760,26928,8.028607000000001,3.6128739999999997,4.215019
192.168.1.2,38036,209.97.172.191,https,24,15888,4.98043,12,12,1381,14507,4.618075,2.208645,2.208645
192.168.1.2,38040,209.97.172.191,https,79,60743,4.996865000000001,34,45,4172,56571,15.609788,6.604141,8.805521
192.168.1.2,38046,209.97.172.191,https,21,16658,4.997730000000001,6,15,1693,14965,4.001817,1.0004540000000002,2.801272
192.168.1.2,38038,209.97.172.191,https,12,8273,4.989917,4,8,950,7323,2.204446,0.601212,1.402829
192.168.1.2,38042,209.97.172.191,https,24,18149,4.982524,8,16,1915,16234,4.616134,1.40491,3.010522
192.168.1.2,38044,209.97.172.191,https,43,28802,4.992965,20,23,1814,26988,8.411835,3.805354,4.406199
192.168.1.2,38036,209.97.172.191,https,25,15948,4.992083999999999,12,13,1381,14567,4.807611,2.203489,2.4038060000000003
192.168.1.2,38040,209.97.172.191,https,77,59904,4.981937,32,45,3330,56574,15.255111,6.222479,8.831906
192.168.1.2,38046,209.97.172.191,https,30,18351,4.992167,15,15,2177,16174,5.809101,2.804393,2.804393
192.168.1.2,38044,209.97.172.191,https,50,37170,4.394669,21,29,2617,34553,11.149873,4.550968,6.371356
192.168.1.2,38036,209.97.172.191,https,24,15888,4.381236,12,12,1381,14507,5.2496599999999995,2.510707,2.510707
192.168.1.2,38042,209.97.172.191,https,11,8212,4.364619,4,7,950,7262,2.2911509999999997,0.687345,1.3746909999999999
192.168.1.2,38038,209.97.172.191,https,11,8233,4.358063,4,7,952,7281,2.294597,0.688379,1.376758
192.168.1.2,38040,209.97.172.191,https,65,59255,4.982894,20,45,2682,56573,12.843942,3.813045,8.830210000000001
192.168.1.2,38046,209.97.172.191,https,30,18465,4.993772,15,15,2291,16174,5.807233,2.803492,2.803492
192.168.1.2,38038,209.97.172.191,https,39,33709,4.939914,11,28,2710,30999,7.6924410000000005,2.024327,5.465682
192.168.1.2,38044,209.97.172.191,https,61,55502,4.892918,18,43,1706,53796,12.262621000000001,3.4744089999999996,8.583835
192.168.1.2,38042,209.97.172.191,https,20,15597,4.838376,7,13,1114,14483,3.926937,1.240085,2.480171
192.168.1.2,38036,209.97.172.191,https,46,30929,4.848051,23,23,1975,28954,9.282081,4.5379059999999996,4.5379059999999996
192.168.1.2,38040,209.97.172.191,https,64,59202,4.413643,18,46,2574,56628,14.273923000000002,3.851694,10.19566
192.168.1.2,38046,209.97.172.191,https,26,17938,4.481488,10,16,2656,15282,5.578504,2.008261,3.3471019999999996
192.168.1.2,38042,209.97.172.191,https,11,8231,0.708066,4,7,950,7281,14.122976999999999,4.236893,8.473786
192.168.1.2,38038,209.97.172.191,https,10,8160,0.7076359999999999,3,7,898,7262,12.718403,2.8263119999999997,8.478935
192.168.1.2,38044,209.97.172.191,https,41,37414,4.994957,12,29,2865,34549,8.008077,2.2022209999999998,5.605654
192.168.1.2,38036,209.97.172.191,https,25,16672,4.994524,13,12,2168,14504,4.805263,2.402631,2.202412
192.168.1.2,38040,209.97.172.191,https,55,58711,4.44104,10,45,2142,56569,12.159314,2.026552,9.907589
192.168.1.2,38046,209.97.172.191,https,26,25005,4.951179,6,20,1926,23079,5.049303,1.0098610000000001,3.8374699999999997
192.168.1.2,38042,209.97.172.191,https,9,8106,0.670262,2,7,844,7262,11.935632,1.491954,8.951724
192.168.1.2,38038,209.97.172.191,https,21,18601,4.997049,6,15,2427,16174,4.002362000000001,1.000591,2.801654
192.168.1.2,38044,209.97.172.191,https,30,28095,4.980135,8,22,1166,26929,5.823135,1.405584,4.216753
192.168.1.2,38036,209.97.172.191,https,25,15948,4.999562999999999,12,13,1381,14567,4.800419000000001,2.200192,2.40021
192.168.1.2,38040,209.97.172.191,https,28,25989,4.973486,7,21,2729,23260,5.428788,1.206397,4.021324
192.168.1.2,38046,209.97.172.191,https,68,67100,4.445176999999999,16,52,2231,64869,15.072515,3.3744440000000004,11.473108
192.168.1.2,38042,209.97.172.191,https,10,8177,0.675499,3,7,896,7281,13.323483,2.9607740000000002,8.882322
192.168.1.2,38038,209.97.172.191,https,17,15797,1.146727,3,14,911,14886,13.952754999999998,1.7440939999999998,11.336613
192.168.1.2,38044,209.97.172.191,https,27,27199,0.020719,5,22,270,26929,1254.886841,193.059525,1013.562439
192.168.1.2,38036,209.97.172.191,https,24,15888,4.417085,12,12,1381,14507,5.207054,2.4903299999999997,2.4903299999999997
192.168.1.2,38040,209.97.172.191,https,58,58877,4.577353,13,45,2304,56573,12.452612,2.621603,9.612542
192.168.1.2,38042,209.97.172.191,https,15,9180,4.992703,8,7,1900,7280,2.804092,1.402046,1.201754
192.168.1.2,38046,209.97.172.191,https,29,17802,4.996857,15,14,2915,14887,5.603522,2.801761,2.601635
192.168.1.2,38038,209.97.172.191,https,20,18548,4.982495,5,15,2373,16175,3.8133510000000004,0.8028109999999999,2.809837
192.168.1.2,38044,209.97.172.191,https,30,28827,4.986087,8,22,1900,26927,5.816185,1.403907,4.21172
192.168.1.2,38036,209.97.172.191,https,46,30929,4.990311,23,23,1975,28954,9.017474,4.408543,4.408543
192.168.1.2,38040,209.97.172.191,https,64,59200,4.474294,19,45,2628,56572,14.080433,4.022981,9.833953
192.168.1.2,38042,209.97.172.191,https,29,17090,4.996437,14,15,2125,14965,5.603993,2.601854,2.801997
192.168.1.2,38038,209.97.172.191,https,10,8164,4.993705,2,8,842,7322,1.802269,0.20025199999999999,1.401765
192.168.1.2,38046,209.97.172.191,https,31,18527,4.9852870000000005,15,16,2293,16234,6.017707,2.808264,3.008854
192.168.1.2,38044,209.97.172.191,https,32,28209,4.987267,9,23,1220,26989,6.215829,1.604085,4.411233
192.168.1.2,38040,209.97.172.191,https,135,109732,4.814798000000001,53,82,4464,105268,27.830868,10.800038,16.823135
192.168.1.2,38036,209.97.172.191,https,25,16676,4.99938,13,12,2168,14508,4.8005949999999995,2.400298,2.200273
192.168.1.2,38042,209.97.172.191,https,30,18465,4.991125,15,15,2291,16174,5.810313,2.804979,2.804979
192.168.1.2,38046,209.97.172.191,https,26,17919,4.474073000000001,10,16,2656,15263,5.58775,2.01159,3.35265
192.168.1.2,38044,209.97.172.191,https,42,28742,4.335294,20,22,1814,26928,9.45726,4.382633,4.843962
192.168.1.2,38038,209.97.172.191,https,18,16358,4.991329,5,13,1874,14484,3.405906,0.8013899999999999,2.404169
192.168.1.2,38040,209.97.172.191,https,24,18198,4.999844,10,14,2757,15441,4.600143,1.800056,2.6000810000000003
192.168.1.2,38036,209.97.172.191,https,25,15948,4.9997489999999996,12,13,1381,14567,4.800241000000001,2.20011,2.4001200000000003
192.168.1.2,38038,209.97.172.191,https,80,67753,4.487388,27,53,2825,64928,17.604897,5.794016,11.588033
192.168.1.2,38044,209.97.172.191,https,80,56529,4.999333999999999,37,43,2732,53797,15.802105,7.200958999999999,8.401119
192.168.1.2,38042,209.97.172.191,https,26,15938,4.954808,13,13,1436,14502,5.045604,2.4218900000000003,2.4218900000000003
192.168.1.2,38046,209.97.172.191,https,26,24868,4.936447,6,20,1809,23059,5.0643709999999995,1.012874,3.848922
192.168.1.2,38040,209.97.172.191,https,12,8151,0.662651,3,9,193,7958,16.599991,3.01818,12.07272
192.168.1.2,38036,209.97.172.191,https,99,68786,4.4350830000000006,48,51,4194,64592,22.096542000000003,10.597322,11.273746000000001
192.168.1.2,38046,209.97.172.191,https,88,68463,4.920006,36,52,3548,64915,17.682904999999998,7.113813,10.365842
192.168.1.2,38042,209.97.172.191,https,14,8930,0.8386680000000001,7,7,1112,7818,15.500770999999999,7.154202000000001,7.154202000000001
192.168.1.2,38038,209.97.172.191,https,28,17143,1.232967,14,14,2239,14904,21.898395999999998,10.543673,10.543673
192.168.1.2,38044,209.97.172.191,https,30,18351,0.759469,15,15,2177,16174,38.184574,18.433933,18.433933
192.168.1.2,38058,209.97.172.191,https,33,17186,0.745456,17,16,2295,14891,42.926746,21.463373,20.121912
192.168.1.2,38036,209.97.172.191,https,80,56526,4.827504,37,43,2732,53794,16.364563,7.457269999999999,8.700148
192.168.1.2,38042,209.97.172.191,https,65,59255,1.316981,20,45,2682,56573,48.595997,14.426935999999998,33.409748
192.168.1.2,38038,209.97.172.191,https,14,8393,0.636683,7,7,1112,7281,20.418325,9.423842,9.423842
192.168.1.2,38046,209.97.172.191,https,28,17127,1.1873200000000002,14,14,2241,14886,22.740289999999998,10.949028,10.949028
192.168.1.2,38044,209.97.172.191,https,30,18351,0.67219,15,15,2177,16174,43.142563,20.827444,20.827444
192.168.1.2,38058,209.97.172.191,https,24,15888,0.6501640000000001,12,12,1381,14507,35.375690000000006,16.918808,16.918808
192.168.1.2,38038,209.97.172.191,https,14,8930,0.669741,7,7,1112,7818,19.41049,8.958688,8.958688
192.168.1.2,38046,209.97.172.191,https,14,8392,0.713689,7,7,1112,7280,18.215216,8.407022,8.407022
192.168.1.2,38042,209.97.172.191,https,28,17127,1.164169,14,14,2241,14886,23.192511,11.166764,11.166764
192.168.1.2,38044,209.97.172.191,https,24,18027,0.811897,9,15,1853,16174,28.328718,9.853467,17.243567000000002
192.168.1.2,38036,209.97.172.191,https,40,28635,0.680254,18,22,1706,26929,57.331528000000006,24.990665,30.870822999999998
192.168.1.2,38058,209.97.172.191,https,98,67447,1.1978520000000001,48,50,4193,63254,80.978287,39.2369,40.906555
192.168.1.2,38038,209.97.172.191,https,61,59028,1.366982,16,45,2466,56562,43.892311,10.973078,32.187695
192.168.1.2,38046,209.97.172.191,https,14,8393,0.761242,7,7,1112,7281,17.077355999999998,7.881856,7.881856
192.168.1.2,38042,209.97.172.191,https,14,8375,0.773137,7,7,1114,7261,16.814613,7.760591000000001,7.760591000000001
192.168.1.2,38044,209.97.172.191,https,30,18351,0.736165,15,15,2177,16174,39.393345000000004,19.017475,19.017475
192.168.1.2,38058,209.97.172.191,https,55,37440,1.222129,26,29,2887,34553,44.185188000000004,20.456106,22.910839000000003
192.168.1.2,38036,209.97.172.191,https,24,15887,0.740165,12,12,1381,14506,31.074152,14.861551,14.861551
192.168.1.2,38046,209.97.172.191,https,64,59201,1.437096,19,45,2628,56573,43.838406,12.525259,30.6173
192.168.1.2,38042,209.97.172.191,https,15,9181,4.98634,8,7,1900,7281,2.807671,1.403835,1.203287
192.168.1.2,38038,209.97.172.191,https,29,17917,4.986638,15,14,3029,14888,5.615005,2.807503,2.606967
192.168.1.2,38044,209.97.172.191,https,31,19025,4.988313,16,15,2851,16174,6.014057,3.007029,2.8065599999999997
192.168.1.2,38058,209.97.172.191,https,35,29098,4.986548,13,22,2170,26928,6.818344000000001,2.4064740000000002,4.21133
192.168.1.2,38036,209.97.172.191,https,25,16675,4.985818,13,12,2168,14507,4.8136529999999995,2.406827,2.206258
192.168.1.2,38046,209.97.172.191,https,21,17484,4.996066000000001,7,14,2597,14887,4.00315,1.2009450000000002,2.602047
192.168.1.2,38042,209.97.172.191,https,74,59743,4.985949,29,45,3170,56573,14.641145000000002,5.615781,8.8248
192.168.1.2,38038,209.97.172.191,https,15,8452,4.994433,7,8,1112,7340,2.803121,1.201338,1.401561
192.168.1.2,38044,209.97.172.191,https,22,18031,4.975454,7,15,1859,16172,4.22072,1.20592,2.813814
192.168.1.2,38058,209.97.172.191,https,45,28796,4.998434,22,23,1808,26988,8.802757000000001,4.201316,4.401379
192.168.1.2,38036,209.97.172.191,https,24,15888,4.982143,12,12,1381,14507,4.6164879999999995,2.2078849999999997,2.2078849999999997
192.168.1.2,38046,209.97.172.191,https,19,16658,4.98263,5,14,1755,14903,3.61255,0.8027890000000001,2.609064
192.168.1.2,38042,209.97.172.191,https,15,8434,4.994297,7,8,1112,7322,2.803197,1.20137,1.401599
192.168.1.2,38044,209.97.172.191,https,32,28095,4.994993,9,23,1106,26989,6.206214,1.601604,4.4044099999999995
192.168.1.2,38058,209.97.172.191,https,29,18405,4.975526,15,14,2291,16114,5.627546,2.813773,2.612789
192.168.1.2,38036,209.97.172.191,https,83,66649,4.457639,32,51,3329,63320,18.395388,6.9543539999999995,11.2167
192.168.1.2,38038,209.97.172.191,https,28,17994,4.957543,14,14,2358,15636,5.4462459999999995,2.622267,2.622267
192.168.1.2,38046,209.97.172.191,https,20,16700,4.997964,5,15,1753,14947,3.8015480000000004,0.800326,2.801141
192.168.1.2,38044,209.97.172.191,https,22,18033,4.996731,7,15,1859,16174,4.202748000000001,1.200785,2.801832
192.168.1.2,38058,209.97.172.191,https,45,28795,4.992426999999999,22,23,1808,26987,8.813349,4.206371,4.406674
192.168.1.2,38036,209.97.172.191,https,24,15886,4.408811,12,12,1381,14505,5.216826,2.495004,2.495004
192.168.1.2,38042,209.97.172.191,https,14,8393,4.326697,7,7,1112,7281,3.0046009999999996,1.386739,1.386739
192.168.1.2,38038,209.97.172.191,https,72,58206,4.599705999999999,28,44,2248,55958,15.435768,5.86994,9.348423
192.168.1.2,38058,209.97.172.191,https,30,18351,4.995814,15,15,2177,16174,5.80486,2.802346,2.802346
192.168.1.2,38044,209.97.172.191,https,41,37963,4.999212,11,30,2077,35886,8.001261999999999,2.000315,5.800914
192.168.1.2,38042,209.97.172.191,https,72,66514,4.954021,21,51,2738,63776,14.331793,4.037125,10.092812
192.168.1.2,38036,209.97.172.191,https,46,30928,4.938143,23,23,1975,28953,9.112738,4.455116,4.455116
192.168.1.2,38046,209.97.172.191,https,22,16328,4.869609,6,16,1089,15239,4.312461,1.026777,3.080329
192.168.1.2,38038,209.97.172.191,https,28,17215,1.2245190000000001,11,17,2108,15107,22.049475,8.166471000000001,13.066355
192.168.1.2,38058,209.97.172.191,https,24,18141,4.979607,9,15,1967,16174,4.618837999999999,1.606552,2.811467
192.168.1.2,38060,209.97.172.191,https,74,54017,4.483397,30,44,4499,49518,16.282297,6.468309,9.590941
192.168.1.2,38044,209.97.172.191,https,38,35002,4.872574,10,28,2144,32858,7.593522999999999,1.847073,5.541219
192.168.1.2,38042,209.97.172.191,https,20,17250,1.1203370000000001,6,14,1807,15443,16.959183,4.462943,11.603651
192.168.1.2,38036,209.97.172.191,https,41,28688,0.644776,19,22,1760,26928,62.037048,27.916672,32.56945
192.168.1.2,38062,209.97.172.191,https,33,17187,0.709432,17,16,2295,14892,45.106506,22.553253,21.143675
192.168.1.2,38058,209.97.172.191,https,11,8233,4.3256239999999995,4,7,952,7281,2.311805,0.693542,1.387083
192.168.1.2,38060,209.97.172.191,https,30,18351,4.389261,15,15,2177,16174,6.607035000000001,3.189603,3.189603
192.168.1.2,38044,209.97.172.191,https,67,57952,4.630725,23,44,1976,55976,14.252628,4.750876,9.285803
192.168.1.2,38042,209.97.172.191,https,58,58866,1.3467120000000001,13,45,2304,56562,42.325309999999995,8.910591,32.672169
192.168.1.2,38036,209.97.172.191,https,41,29422,4.9985550000000005,19,22,2494,26928,8.002313000000001,3.6010410000000004,4.201214
192.168.1.2,38062,209.97.172.191,https,25,16674,4.996505,13,12,2168,14506,4.803358,2.401679,2.201539
192.168.1.2,38060,209.97.172.191,https,49,42461,4.935701,15,34,2926,39535,9.725062,2.836477,6.685980000000001
192.168.1.2,38058,209.97.172.191,https,20,15577,4.886006,7,13,1114,14463,3.888657,1.227997,2.455994
192.168.1.2,38044,209.97.172.191,https,33,18021,1.126224,16,17,2378,15643,28.413529999999998,13.318842000000002,14.206764999999999
192.168.1.2,38042,209.97.172.191,https,79,59471,1.153877,34,45,3438,56033,67.59819,28.599235999999998,38.132313
192.168.1.2,38036,209.97.172.191,https,40,28520,4.99578,18,22,1592,26928,7.806589,3.402872,4.2035480000000005
192.168.1.2,38062,209.97.172.191,https,24,15889,4.996569999999999,12,12,1382,14507,4.6031580000000005,2.20151,2.20151
192.168.1.2,38042,209.97.172.191,https,74,60474,4.989323000000001,29,45,3902,56572,14.631243,5.611984,8.818831
192.168.1.2,38060,209.97.172.191,https,12,9018,4.990355999999999,5,7,1738,7280,2.204252,0.801546,1.2023190000000001
192.168.1.2,38058,209.97.172.191,https,23,17594,4.990121,9,14,2707,14887,4.408711,1.603168,2.605147
192.168.1.2,38064,209.97.172.191,https,34,17975,4.986191000000001,18,16,3082,14893,6.618278999999999,3.4094160000000002,3.008308
192.168.1.2,38036,209.97.172.191,https,34,19583,4.988599,17,17,3032,16551,6.6150839999999995,3.2073139999999998,3.2073139999999998
192.168.1.2,38062,209.97.172.191,https,43,28803,4.987301,20,23,1814,26989,8.421389,3.809676,4.411204
192.168.1.2,38042,209.97.172.191,https,14,8930,4.983724,7,7,1112,7818,2.608491,1.203919,1.203919
192.168.1.2,38060,209.97.172.191,https,11,8231,4.9816139999999995,4,7,950,7281,2.007381,0.602214,1.2044290000000002
192.168.1.2,38058,209.97.172.191,https,22,16804,4.981201,8,14,1917,14887,4.215851,1.405284,2.609812
192.168.1.2,38064,209.97.172.191,https,94,68135,4.967557,42,52,4503,63632,18.721476000000003,8.253554,10.266616
192.168.1.2,38036,209.97.172.191,https,18,16806,4.937511,4,14,950,15856,3.4430300000000003,0.607594,2.632905
192.168.1.2,38062,209.97.172.191,https,63,42676,4.984183,31,32,2407,40269,12.439351,6.0190410000000005,6.219676
192.168.1.2,38042,209.97.172.191,https,67,58631,0.641201,22,45,2056,56575,102.931839,32.751041,68.621223
192.168.1.2,38060,209.97.172.191,https,10,7441,0.684457,3,7,162,7279,13.149109,2.922024,8.766073
192.168.1.2,38058,209.97.172.191,https,21,16014,1.115099,7,14,1127,14887,17.935629000000002,5.380688,11.658158
192.168.1.2,38064,209.97.172.191,https,21,16967,4.964837,7,14,1112,15855,4.028329,1.208499,2.618414
192.168.1.2,38036,209.97.172.191,https,29,28040,4.420628,7,22,1112,26928,6.333941,1.357273,4.750456
192.168.1.2,38062,209.97.172.191,https,4,2008,4.432294000000001,2,2,841,1167,0.67685,0.225617,0.225617
192.168.1.2,38042,209.97.172.191,https,80,60802,4.991812,34,46,4172,56630,15.825915,6.610825999999999,9.014762
192.168.1.2,38060,209.97.172.191,https,13,9064,4.983805,5,8,1742,7322,2.4077990000000002,0.8026,1.404549
192.168.1.2,38058,209.97.172.191,https,38,28415,4.986008,14,24,4239,24176,7.420766,2.607296,4.612908999999999
192.168.1.2,38062,209.97.172.191,https,46,30928,4.785216,23,23,1975,28953,9.403964,4.597494,4.597494
192.168.1.2,38064,209.97.172.191,https,20,15613,4.799008000000001,7,13,1112,14501,3.9591519999999996,1.250258,2.500517
192.168.1.2,38036,209.97.172.191,https,52,55016,4.749642,9,43,1220,53796,10.737652,1.684337,8.842772
192.168.1.2,38058,209.97.172.191,https,21,16971,4.932268,7,14,1114,15857,4.054930000000001,1.216479,2.635704
192.168.1.2,38042,209.97.172.191,https,88,68803,4.902883999999999,36,52,4414,64389,17.744657999999998,7.138656,10.40204
192.168.1.2,38060,209.97.172.191,https,25,17866,4.413048000000001,9,16,2602,15264,5.438418,1.8128060000000001,3.3990110000000002
192.168.1.2,38064,209.97.172.191,https,12,9018,4.998974,5,7,1738,7280,2.200452,0.800164,1.200246
192.168.1.2,38036,209.97.172.191,https,28,28605,4.996462999999999,6,22,1678,26927,5.403823,1.000708,4.202973
192.168.1.2,38062,209.97.172.191,https,25,16674,4.997402,13,12,2169,14505,4.8024949999999995,2.401248,2.2011439999999998
192.168.1.2,38058,209.97.172.191,https,22,16805,4.39785,8,14,1917,14888,4.775061,1.591687,2.9559900000000003
192.168.1.2,38060,209.97.172.191,https,31,25273,4.893822,11,20,2196,23077,6.130178,2.043393,3.882446
192.168.1.2,38042,209.97.172.191,https,50,49460,0.062321,12,38,679,48781,786.2518309999999,176.50550800000002,593.700378
192.168.1.2,38066,209.97.172.191,https,33,17187,0.735632,17,16,2295,14892,43.500011,21.750006,20.390631
192.168.1.2,38064,209.97.172.191,https,23,17418,4.9923269999999995,8,15,1915,15503,4.406763,1.402152,2.804303
192.168.1.2,38062,209.97.172.191,https,45,28911,4.9977730000000005,22,23,1922,26989,8.803921,4.201871,4.40196
192.168.1.2,38036,209.97.172.191,https,20,17816,4.98479,4,16,1583,16233,3.8115949999999996,0.601831,3.009154
192.168.1.2,38058,209.97.172.191,https,22,17114,4.960573,8,14,2034,15080,4.233382,1.411127,2.6206650000000002
192.168.1.2,38060,209.97.172.191,https,70,58098,4.326295,26,44,2140,55958,15.948982,5.778617,9.939219999999999
192.168.1.2,38066,209.97.172.191,https,25,16673,4.994579,13,12,2168,14505,4.80521,2.402605,2.202388
192.168.1.2,38036,209.97.172.191,https,26,19145,4.994111,10,16,2654,16491,5.005896,1.8021220000000002,3.0035369999999997
192.168.1.2,38064,209.97.172.191,https,22,16823,4.376341,8,14,1917,14906,4.798529,1.59951,2.970518
192.168.1.2,38062,209.97.172.191,https,44,28851,4.359989,22,22,1922,26929,9.86241,4.8165260000000005,4.8165260000000005
192.168.1.2,38058,209.97.172.191,https,72,59507,4.643581,27,45,2941,56566,15.289925,5.599126999999999,9.475446
192.168.1.2,38060,209.97.172.191,https,90,60065,1.3337450000000002,45,45,4032,56033,66.729401,32.989815,32.989815
192.168.1.2,38066,209.97.172.191,https,24,15886,4.9859800000000005,12,12,1381,14505,4.612935,2.206186,2.206186
192.168.1.2,38036,209.97.172.191,https,35,17944,4.995503,17,18,1569,16375,6.806121000000001,3.202881,3.403061
192.168.1.2,38064,209.97.172.191,https,20,15596,4.929142,7,13,1112,14484,3.854626,1.21725,2.434501
192.168.1.2,38062,209.97.172.191,https,78,53725,4.934531,38,40,2786,50939,15.604320000000001,7.4981789999999995,7.903486
192.168.1.2,38058,209.97.172.191,https,28,17801,4.1136800000000004,14,14,2358,15443,6.563467,3.160187,3.160187
192.168.1.2,38060,209.97.172.191,https,15,9179,0.699242,8,7,1917,7262,20.021681,10.01084,8.58072
192.168.1.2,38066,209.97.172.191,https,23,15099,0.648985,11,12,594,14505,33.899086,15.408676000000002,16.949543
192.168.1.2,38068,209.97.172.191,https,11,2161,0.076226,6,5,1715,446,131.188828,65.594414,52.475533
